##########################
#   #                    #
#                        #
#  #                     #
#                        #
#                        #
#        #               #
#                        #
#                 #      #
#                        #
#             #          #
#        #               #
#                        #
##########################