**#*#############*###########*##########*###########*##*##*#*####*#*#################*########*#####
#***#*****#*******#*#***#*****#*****#*******#*****#***#*******#*****************#***#*******#*******
#*#*#*###*#*###*#***#*#***#*#*#*###***####**###*#*#*#*#####*#*###*#########*#*##**#*#*#*###*#*#####*
#*#***#***#*#***#*#***#***#*#*#***#*#*#***#*********#*******#***#*********#*#*#***#***#*#***#*#*****
#*#*###*###*#*#***#*#####*#*#*#*#*****#*#*#####*###*###########**##**##*#*###*#**######***###*#####*
#*****#***#*#***#*********#*#***#*#*#*#*****#*******#*********#***#*#***#***#***#***#*#*#*****#***#*
#########*#*#*###*#########*##*##*#***#*###*#####*###*####**#*##***#**###*#*###*#*#*#*#*#####***#*##
#*****#***#*#***#*#*****************#*****#*****#***#*****#*#***#*****#***#***********#*#***#*#*#***
#*###*#*#***###*#***#########*###*###########*#*###*#*####**#**##*#####*#####*##*##*#*#*#*#*#*#*###*
#*#*****#*****#*****#***#***#***********#***#*****#***#*****#*#***#***#*****#*****#*#*#***#*#*#*#***
#*######*##***#*#***#*#*#*#****##*#*#*#*#****##*#*###*#*#######*#*#*#*#*#*####*##*#*#*#####*#*#*#*#*
#***#*******#*******#*#***#*****#*#*#*****#***#*#*****#***#*****#*******#*#*******#*******#*******#*
#*#*#*#####*#####***#*#########*###*#########*#####*#*###*#*##*########*#***#########*#*#*######*##*
**#*#*#***#*******#***#*******#***#***#*****#*******#*#***********#***#***#***#*****#*#***#*****#***
#*#*#*#*#*###*#*#*#####*##*##*##**#*#*#*###*#########***##*####*###*#*##**###*#*#***#*#***#*###*#*##
#*#*****#*****#*#*****#*#*****#***#*#*#***#*********#*******#*******#***#***#*#*#*******#*#***#*#***
#*#**##*#*###*#*#####***#*#####*#####**##*##*####*#*##*###**#*######*##*##**#**##########*#*#*#*###*
#*********#*****#***#*#*#***#*******#***#***************#***#*********#*****#***#*****#*************
#*#####*###*###*#*###*###***#*###*#*###*###*###*#*####**#*###*#####*#*###*##*##*#*###*##*####**####*
#*#***#***#***#***#***#*****#*#***#*****#***#***#*****#*#*#*#*****#*#*****#***#***#*#***#*****#*****
#*#*#*##*####*###*#*###*###*#*#*###########*#*###*#***#*#*#*#####**##*#*###*#*#*###*###***#*#****###
#*#*#*********#*********#***#***#***********#*#*#***#*#*#*****#*#***#***#*#*#***********#*#***#*****
#*#*####**########**#*###*#*#####*##*#*##*#*#*#*#*###*#*#*###*#*###***#*#*#*##*##***###***########**
#*#***#***#*********#***#*#*#*****#*****#*#***#*****#***#*******#***#*****#***#*#*#*#***#***********
#*###*#*#*#*#*#*#######*#*###*#*#*#**##*#*########*#*##*#*#####*#****####*###***#*###*###*#*###*###*
****#*****#*#***#***#***#*****#***#*#***#*******#*****#***#*****#*#*#***#*#*#*#*#*#*******#*#***#***
###*#*#*###*####**#*#*###*##**####**#####*##*##****##**####*#####*###*#***#*#*#*#***#####*###*###*##
****#*#***#*#***#*****#*#***#***#*************#*#*#***#***#***#*#*****#*#***#***#***#***#***#***#***
#####*####****#*#**###**#*#*#*#*#*#*#*###*##*##*#*#*##*****##*#*#######*#*#*#*#*#####*#*###*#***###*
#*****#***#***#***#*******#*#*#***#*#***#*#***#***#*****#*****#*******#*****#*#*************#*#*#***
#*#####*#*##*#*######***#*#*#*###*#*##**#*#*#*#####**#*#**########**##*##*#*#*#*####*####*#*#*#*****
**#***#*#*************#*#*****#***#*****#***********#*****#*******#*****#*****#***#*********#*#*#*#*
#*#*#*#*###*#*##*#####*#**####**#*#####*##*####**#*##*#*#*#*#####*#*#*#*######*##*#*######**###*#*#*
#*#*#***#***#***********#***#***#***********#*#*#*****#*#***#*****#*#*#*#***#***#*#***#***#*****#*#*
#*#*#####*#*#*#**#*####**##*#*##*###**#**##*#*#*#*#####*#####*#######***#***#*#*#*###*##**#**#**#***
#***#*****#*#*#*****#*****#***#*****#*****#*********#***#***#*******#*#***#***#*#*******#***#*****#*
**###*###*#*######**#*###*#####*#*#*#####*###*#####*#*###*#*#######*#*#########*#***###*#####*####**
#***#*#*#*#*******#*#*****#***#*#*********#***#***#*#***#*#*#***********#***#***#*#*#*********#*#***
**#*#*#*#*#####*###*#*###*#***#*###*###########*#*#####*#*#*#*#*#*#*###*#*#*#*#*##**#*#########*#*##
#*****#*******#*********#***#*******************#*********#***#*********#*#*********#***************